5 10
|--------|
|.F.|..-.|
|.._|.@..|
|.F....-.|
|--------|