5 10
|--------|
|.F.|..-.|
|.._|.@P.|
|.F....-.|
|--------|