5 10
|--------|
|...|.._.|
|.._|.@..|
|......_.|
|--------|